.X.X.#..#.X......XX.XX.XX#..X#..X..#.XX.X...X..XXXX.X.XX....XX.XXX.X.XX.XX...X..X.X.X.XX...#XXX.X.XX..X..XX.X.X..X..X....##.......
.X.X......X......XX.XX#XXXXXXXXXXXXXXXXXXXXXXXXXXXXXXXXXXXXXXXXXXXXXXXXXXXXXXXXXXXXXX#XX....XXX.X.XX#.X..XX.X.X..X..X..........#..
.X.X.....#XXXXXXXXXXXXXXXXXXXXXXXX#XXXXXXXXXXXXXXXXXXXXXXXXXXXXXXXXXXXXXXXXXXXXXXXXXXXXX#...XXX.X.XX..X#.XX.X.X..X.#X.......##....
.X.X.....X#......XX.XXXXX...X...X#.XXXX#XXX#XXXXXXXXXXXX#XXXXXXXXXXXXXXXXXXXXXXXXXX#X.XX.#..XXX.X.XX..X..XX.X.X..X..X.............
#XXXXXXXXXXXXXXXXXXXXXXXXXXXXXXXXXXXXXXXXXXXXXXXXXXXXXXXXXXXXXXXXXXXXXXXXXXXXXXXXXXXXXXXXXXXXXXXXXXXXXXXXXXXXXXXXXXXX#............
.#.X..#..X.......XX.XXXXX...X#..XX.XXXXXXXXXXXXXXXXXX#XXXXXXXXXXXXXXXXXXXXXXXXXXXXXXX#XXX#XXXXX#XXXXXXXXXXXXXXXXXXX#X.......#.....
..#X.#XXXXXXXXXXXXXXXXXXXXXXX##.XX.XXXX#XXXXXXXXXXXXXXXXXXXXXXXXXXXXXXXXXXXXXXXXXXXXXXXXXXXXXXXXXXXXXXX#XXXXXXXX#XXXX.....#.......
XXXXXXXXXXXXXXXXXXXXXXXXXXXXXXXXXXXXXXXXXXXXXXXXXXXXXXXXXXXXXX#XXX#XXXXXXXXX#XX#XXXXXXXXXXXXXXXXXXXXXXXXXXXXXXXXXXXXXXXXXXXXXXXXXX
XXXXXXXXXXXXX####XXXXXXXXXXXXXXXXX.XXXXXXXXXXXXXXXX#XXXXXXXXXX.XXXXX#XX#XXXXXXXXXXXXXXXXXXXXXXXXXXXXXXXXXXXXX#XXXXX#X.............
..XX.XXXXX#XXXXXXXXXXXXXXXX#XXXXXXXXXXXXXXXXXXXXXXXXXXXXXXXXXXXXXXXXXXXXXXXX#XXXXXXXXXXXXXXXXXXXXXXXX#XXXXX#XXXXXXXXXXXXXXXXXXXXXX
XXXXXXXXXXXXXXXXXXXXXXXXXXXXXXXXXXXXXXXXXXXXXX#XXXX.XXXX#XXXXX.XXXXXXXXXXXXXXX#XXXXXX.XXXXXXXXX.X#XXXXXXXXXXXXXXXXXXXXXXX#........
XXXXXXXXXXXXXXXXXXXXXXXXXXXXXXXXXXXXXXXXX##XX#XXXXXXXXXXXXXXXXXXXXXXXXXXXXXXXXX#XXXXX#XXXXXXXXXXXXXXXXXXXXXXXXXXXXXXX...X.........
..XX.XXXXXXX#X.#XXX#XXXXXXXXXXXXXXXXXXXXXXXXXXXXXXX#X#XXXXX#XXXXXXXXXXXXXXX#XXXXXXXXXXXXXXXXXXXXXXXXXXXXXXX#XXXXXXXXX...X.#.#.#..#
XXXXXXXXXXXXXXXXX#XXXXXXXXXX#XX#XX.X#XXXX..XXXXXXXXXXXXXXX#XXXXXXXXXXXXXXXXXXXXXXXXXXXXXXXXXXXXXX##XXXXXXXX.XXX#XXXXX...X.XXXXXXXX
..XX.XX#XXXX#XXXXXXXXXXXXXXXXXXXXX#XXXXXX##XXXXXXXXXXXXXXXXXXX#XXXXXXXXXXXXXX#XXXXXXXXXXXXXXXXX#XXXXXXXX#XX#XXXXXX#XX...X.X.......
XXXXXXXXXXXXXXXXXXXXXXXXXXXXXXXXXXXXXXXXXXXXXXX#XXXXXXXXXXXXX#XXXXXXXXXXXXXXXXXXXXXXXXXXXXXXXXXXXXXXXXXXXXXXXXXXXXXXXXXXXXXXXXXXXX
..XX.XXXXXXXXX#XXXXXXXXXXXXXXXXXXXXXXXXXXXXXXXXXXXXXXXXXXXXXX##XXXXXXXXXXXXXXXX.X#XXXXXXXXXXXXXXXXXXXXXXXXXX#XXXXXXXX...X#X.......
..XX.XXXXXXXXXXX#XXXXXXXXXXXXXXXXXXXXXXX#XX#XXXXXXXXXXXXXXXXXXXXXXXXXXXXXXXXXXXXXXXXXXXXXXXXXXXXXXXXXXXX#XXXXXXXXXX#X.#.X.X.....#.
.#XXXXXXXXXXXXXXXXXXXXXXX###XXXXXX.XXXXX#XXXXXXXXX#XXXXXXXXXXXXXXXXXXXXXXXXXXXXXXXXXXXXXXXXXXXXXXXXX#XXXXXXXXXXXXXXXXXXXXXXXXXXXXX
...X.XXX#XXXXXXXXXXXXXXXXXXXXXXXXXXXXXXXXXXXXXXXXXXXXXXXXXXXXXXXXXXXXXXXXXXXXXXXXXXXXXXXXXXXXXX#XXXX.#XXXXXXX#XX.#XXX...X.X.......
#.#XXXXXXXXXXXXXXXXXXXXXXXXX#XX#XXXXXXXXXXXXXXXXXXXXXXXXXXXXXXXXXXXXXXXXXXXXX#XXXX#XXXXXXXXXXXXXXXXXXXXXXXX#XXXXXXXXXXXXXXXXXXXXXX
..XXXXX#XXXXX#XXXXXXXXXXXXXXXXXXXXXXXXXXXXXXX#XXXXX#XXXXXXXXXXXXXXXXXXXXXX#XXXXXXXXXXXXXXXXXXXXXXXXXXXXXXXXX#.XX.X#XX.#.X.X.......
XXXXXXXXXXXXXXXXXXXXXXXXXXXXXXXXXXXXXXXXXXXXXXXXXXXXXXXXXXXXXXXXXXXXXXXXXXXXXXXXXXXXXXXXXXXXXXXX#XXXXXXXXXXX.#XXXXXXXXXXXXXXXXXXXX
..X..XX#XXXXXX#XXXXXXXXXXXXXXX#XXX#XXXXXXXXXXXXXXXXXXXXXXXXXXXX#XXXXXXXXXXXXXXXXXXXXXXXXXXXXXXXX#XXXXXXXXXXX.XXXXXXXXXXXXXXXXXXXX#
.#XXXXXXXXXXXXXXXXXXXXXXXXXXXXXXXXXXXXXXXXXXXXXXXXXXXXXXXXXXXXXXXXXXXXXXXXXXXXXXXXXXXXXXXXXXXXXXXXXXXXXXXXXXXXXXXXXXXXX#X.X...#.X.
.XXXXXXXXXX#XXXXXXXXXXXXXXXXXXXXXXXXXXXXXXXXXXXXXXXXXX#XXXXXXXX#XXXXXXXXXXXXXXXXXXX#XXXXXXXXXXXXXXXXXXXXXXXXXXXXXXXXXXXXXXXXXXXXXX
.X..#XXXXXXXXXXXXXXXXXXXXXXXXXXXXXXXXXXXXXXXXXXXXXXXXXXXXXXXXXXXXXXXXXXXXXXXXXXXXXXXXXXXXXX#XXXXX##X#XXXXXXXXXXXXXXXXXX.#.X.....X.
.X.#XXXXXXXXXXXXXXXXXXXXXXXXXXXXXXXXXXXXXXXXXXXXXXXXXXXXXXXXXXXXXXXXXXXXXXXXXX##XXXXXXXXXXXXXXXXXXXXXXXXXXXXXXXXXXXXXXX#..X..#..X.
#XXXXXXXX#XXX.XXXXXXXXXXXX#XXXXXXXXXXXXXXX#XXXXXXXXX#XX#X#XXXXXXXXXXXXXX##XXXXXXXXXXXXXX#XXXXXXXX#XXXXXXXXXXXX#XXXX#XXX..#X.....X.
.X...X#XXXXXXXXXXXXXXXXXXXXXXXXXXXXXXXXXXXXXX#XXXXXXXXXXXXXXX#XXXX#XX#XXXXXXXXXXXXXXXXXXXXXXXXXXX#XXXXXXXXXXXXXXXXXXXXX..XXXXXXXXX
#XXXXXXXXXXXXXXXXXXXXXXXXXXXXXXXXXXXXXXXXXXXXXXXXXXXXXXXXXXXXXXXXXXXXXXXXXXXXXX#XXXXXXXXXXXX#XXX#XX#XXXXXXXXXXXXXXXXXXX.#XX....#X.
.X...X.#XXXXXXXXXXXXXXXXXXXXXXXXXXXXXXXXXXXXXXXXX#XXXXXXXXX#X.XXXXX#XXXXXXXXXXXXXXXXXXXXXXXXXXXXXXXXXXXX#XXXXXXXXXXXXXX..XX.....X.
.X...X#XXXXXX#XXXXXXXXXXXXXXXXXXXXXXXXXXXXXXXXXXXXXXXXXXXXX#XXXXXXXXXXXXXXXXXXXXX#XXXXXXXXXXX#XXXXXXXXXXXXX#XX#XXXXXXXX..XX.....X.
#XXXXXXXXXXXXXXXXXXXXXXX#XXXXXXXX#XXXXXXXXXXXXXXXXXXXXXXXXXXXXXXXXXXXXXXXXXXXX##XXXXXXXXXXXXXXXXXXXXXXXXXXXXXX#XXXXXXXX..XX.....X.
XXXXXXXXXXXXXXXXXXXXXXXXXXXXXXXXXXXXXXXXXXXXXXXXXXXXXXXXXXXXXXXXXXXXXXXXXX#XXXXXXXXXXXXXXXXXXXXXXXXXXXXXXXXXXXXXXXX#XXX.#XX....#X.
.....XXXXX#XX#XXXXXXXXXXXXXXXXXXXXXXXXXXXXXXXXXXXXXXXXXXXXXXX#XXXXXXXXXXXXXXXXXXXXXXXXXXXX#X#XXXXXXXXXXXXXXXXXXXXXXXXXX..XX#....X.
....#XXXXXXXXXXX#XX#XXXXXXXXXXXXXXXXXXXXXXXXXXXXXXXXXXX#XXXXXXXXXXXXXXXXXXXXXXXXXXXXXXXXXXXXXXXXXXXXXXXXXXXXXXXXXXXXXXXX#XX.....X.
XXXXXXXXXXXXXX#XXXXXXXXXX#XXXXXXXXXXXXXXX#XXXX#XXXXXXXXXXXXXXXXXXXXXXXXXXXXXXXXXXXXX#XXXXXXXXXXXXXXXXXXXXXXX#XXXXXXXXXXXXXXXXXXXXX
XXXXXXXXXXXXX#.X.XXXXX#XX..#XXXXXXXXX#XXXXXXXXXXXXXXX#XXXXXXXXX#XXXXXXXXXXXXXXXXXXXXXXXXXXXXXXXXXXXXXXXXXXXXXXXXXXXXXXXXXXXXXXXXXX
.#...XXX#XXXXXXXXXXXXXXXXXXX#XXXXXXX#XXXXXXXXXXXXXXXXXXXXXXXXXXXXXXXXXXXXXXXXXXXXXXXXXXXXXXXXXXXXXXXXXXXXXXXXXXX#XXXXXXXXXX...#.X.
XXXXXXXXXXXXX##XXXXXXXXXXX#XXXXXXXXXXXXXXXXXXXXXXXXXXXXXXXXXXXXXXXXX#XXXXXXXXXXXXXXX.XXXXXX#XXXXXXXXXXXXXXXXXXXXXXX#XXXXXXX.....X.
.....#XXXXXXXXXXXXXXXX#XXXXX#XXXXXXXXXXXXXXXXXXX##XXXXXXX#XXXXXX#XXXXXXXXXXX#XXXXXXX#XXXXXXXXXXXXXXXXXXXXXXXXXXXXXXXXXXXXXXXXXXXX#
.#..#XXXXXXXXXXXXXXXXXXXXXXXXXXXXXXXXXXXXXXXXXXXXXXXXXXXXXXXXXXXXX#XXXXXXXXXXXXXXXXXXXXXXXXXXXXXXXXXXXXXXXXXXXXXX#XXXXXXXXX.....X.
.XX#.XXXXX#XXXXXXXXXXXXXXXXXXXXXXXXXXXX#XXXXXXXXXXXXXXXXXXXXXXXXXXXXXXXXXXXXXXXXXXXXXXXXXXXXXXXXXXXXXXXXXXXXXXXXXXXXXXXXXXXXXXXXXX
XXXXXXXXXXXXXXXXXXXXXXXXXXXXXXXXXXXXXXXXXXXXXXXXXXXXXXXXXXXXXXXXXXXXXXXXXXXXXXXXXXX#XXXXXXXXXXXXXXXXXXXXXXXXXXXXXXXXXXXXXXXXXXXXXX
#XXXXXXXXXXXXXXXXXXXXXXXXXXXXXXXXXXX#XXXXXXXXXXXXXXXXXXX##XXXXXXXXXXXXXXXXXX#XXXXXXXXXXXXXXXXXXXXXXXXXXXXXXXXXXXXXXXXXXXXXXX#...X.
..X..XXXXXXXXXXX#XXXXX#XXXXXXXXXXXXXXXXXXXXXXXXXXX#XXXXXXXXXXXXXXXXXXXXXXXXXXXXXXXXXXXXXXXXXXXXXXXXXXXXXXXXXXXXXXXXXXXXXXXXXXXXXXX
XXXXXXXXXXXXXXXXXXXXXXXXXXXXXXXXX#XXXXXXXXXXXX#XXXXXXXXXXXXXXXXXXXXXXXXXXXXXXXXXXXXXXXXXXXXXXXXXXXXXXXX#XXXXXXXXXXXXX#XXXXXX....X.
XXXXXXXXXXXXXXXXXX#XXXXXX#XXXXXXXXXXXXXXXXXXXXXXXXXXXXXXXXXXXXXXXXXXXXXXXXXXXXXXXX#.XXXXXXX#XXXXXXXXXXXXXXXXXXXXXXXXXXXXXXXXXXXXX.
..#..XXX#XXXXXXXXXXXXXXXXXXXXXXXXXXXXXXXXXXXXXXXXXXXXXXXXX#XXXXXXXX#XXXXXXXXXXXXXXXXXXXXXXXXXXXXXXXXXXXXXXXXXXXXXXXXXXXXXXXXX#..#.
..XXXXXXXXXXXXXX#XXXXXXXXXXXXXXXXXXXXXXXXXXXXXX#XXXXXXXXXXXXXXXXXXXXXXXXXXXXXXXXXXXXXXXXXXXXXXXXXXXX#XXXXXXXXXXXXXXXXXXXXXXXX.....
XXXXXXXXXXXXXXXX#XXXX#XXXXXXXXXXXXXXXXXXXXXXXXXXXXXXXXXXXXXXXXXX#XXXXXXXXXXXXXXXXXXXXXXXXXXXX#XXXXXXXXXXXXXXXXXXXXXXXXXXXXXXXXXXXX
..X..XXXXXXXXXX#XXXXXXXXXXXXXXXXXXXXXXXXXXXXXXXXXXXXXXX#XXXXXXXXXXXXXXXXXXXXXXXXXXXXXXXXXXXXX#XXXXXXXXXXXXXXXXXXXXXXXXXXXXXX#.....
XXXXXXXXXXXXXXXXXXXXXXXXXXXXXXXXXXXXXXXXXXXXXXXXXX#XXXXXXXXXXXX#XXXXXXXXXXXXXX#XXXXXXXX##X#XXXXXXXXXXXXXXXXXXXXXXXXXXXXXXXXXXXXX#.
.#XXXXXXXXXXXXXXXXXXXXXXXXXXXXXXXXXX#XXXXXX#XX#XXXXXXXXXXXX#XXXXXXXXXXXXXXXXX#XXXXXXXXXXXXX#XXXXXX#XX#XXXXXXXXXXXXXXXXXXXXXXX#.X..
XXXXXXXXXXXXXXXXXX#XXXXXXXXXXXXXXXXXXXXXXXXXXXXXX#XXXXXXXXXXXXXXXXXXXXXXXXXX#XXXXXXXXXXXXXXXXXXXXXXXXXX##XXXXXXXXXXXX#XXXXXXX#.X..
.....XXXX#XXXXXXXXXXXXXXXXXXXXXXXXXXXXXXXXXXXXXXXXXXXXXXXXXXXXXXXXXXXXXXXXXX#XXXXXXXXXXXXXXXXXXX#XXXXXXXXXXXXXXXXXXXXXXXXXX#XXXX..
XXXXXXXXXXXXXXXX#XXXXXXXXXXXXXXXXXXXXXXXXXXXXXXXXXXXX#XXXXXXXXXXXX#XXXXXXXXXXXXXXXXXXXXXXXXXXXXXXXXXXXXXXXXXXXXXXXXXXXXXXXXXXXX#..
..##.XXXXXXXXX#X#XX#XXXXXXXXXXXXXXXXXXXXXXXX#XXXX#XXXXXXXXXXXXXXXXXXXXXXXXXXXXXXXXX#XXXXXXXXXXXXXXXXXXXXXXXXXXXXXXXXXXXXXXXXXXXXX#
XXXXXXXXXXXXXXXXXXXXXXXXXXXXXXXXXXXXXXXXXXXX#XXXXXXXXXXXXXXXXXXXXXXXXXXXXXXXXXXXXXXXXXXXXXXXXXXXXXXXXX#XX#XXXXXXXXXXXXXXXXX.X#X.X#
XXXXXXXXXXXXXXXXXXXXXXXXXXXXXXXXXXXXXXX#XXXXXXXXXXXXXXXXXXXXXXXXXXXXXXXXXXXXXXXXXXXXXXXXXXXXXXXXXXXXXXXXXXXXXX#XXXXXXXXXXXX.X.X.X.
....#XXXXXXXXXXXXXXXXXXXXXXX#XXX#XXXXXXXXXXXXXXXXXXXXXXXXXXXXXXXXXXXXXXXXXXXXXXXXXXXXXXXXXXXXXXXXXXXXXXXXX#XXXXXXXXXXXXXXXX#XXX.X.
.....XXXXXX#XXXXXXXXXXX#XXXXXXXXXXXX#XXXXX#XXX#XXXXXXXXXXXXXXXXXXX#XXXXXXXXXXXXXXXXXXXXXXXXXXXXXXXXXXXXXXXX#XXXXXXXXXXXXXXX.X##.X.
....#XXXXXXXXXXXXXXXXXXXXXXXXXXXXXXXXXXXXXXXXXXXXXXXXXXXXXXXXXXXXXXXXXXXXXXXXXXXXXXXXXXXXXXXXXXX#XXXXXXXXXXXXXXXXXXXXXXXXXXXXXXXXX
XXXXXXXXXXXXXXXXXXXXXXXXXXXXXXXXXXXXXXXXXXXXXXXXXXXXXXXXXXXXXXXXXXXXXXXXXXXXXX#X#XXXXXXXXXXXXXXXXXXXXXXXXXXXXXXXXXXXXXXXXXXXXX#.X.
....XXXXX#XX#XXXXXXXXXXXXXXXXXXXXXXXXXXXXXXXXXXXXXXXXXXXXXX#XXXXXXXXXXXXXXXXXXXXXXXXXXXXXXXXXXXXXXXXXXXXXXXXXXXXXXXXXXXXXXXXXXXXXX
#...XXXXXXXXXXXXXXXX#XXXXXXXX#XXXXXXXXXXXX#XXXXXXX#XXXXXXXXXXXXXXXXXXXXX#XXXXXXXXXXXXXXXX#X#X#XXXXXXXXXXXX#XXXXXXXXXXXXXXXX.X#..X.
....XXXXXXXXXXXXXXXXXXX#XXXXXXXXXXXXXXXX#XXXXX#XXXXXXXXXXX#XXXXXXXXXXXXXXXXXXXXX#XXXXXXXXXXXXXXXXXXXXXXXXXXX#XXXXXXXXXX#XXX.X...X#
XXXXXXXXXXXXXXXXXXXXXXXXXXXXXXXXXXXXXXXXXXXXXXXXXXXXXXXXXXXXXXXXXXXXXXXX#X#XXXXXXXXXXXXXXXXXXXXX#XXXXXXXXXXXXXXXXXXXXXXXXXXXXXXXXX
...#XXXXXXXXXXXXXXXXXXXXXXXXXXXXXXXXXXXXXXXXXXXXXXXXX#XXXXXXXXXXXXXXXXXXXXXXXXXX#XXXXXXXX#XXXXXXXXXXXXXXXXXXXXXXX#XXXXXXXXX.X...X.
XXXXXXXXXXXXXXXXXXXXXXXXXXXX#.XXXXXXXXXX#X.XXXXX#XXXXXXXXXXXXXXXXXXXXXXXXXXXXXXXXX#X##XXXXXXXXXXX#XXXXXXXXXXXXXXXXXXXXXXXXXXXX#.X.
...##XXXXXXXXXXXXXXXXXXXXXXXXXXXXXXXXXXXXX#XXXXXXXXXXXXXXXXXXXXXXXXX#XXXXXXXXXXX#XXXXXXXXXXXXXXXXXXXXXXXXXXXXXXXXXXX#XXXXXX.XX..X.
#.#..#XXXXXXXXXXXXXXXXXXXXXXXXXXXXXXXX#XXX.XXXXX#XX#X#XXXXXXXXXX#XXXXXXXXXXXXXXXXXXXXXX#XXXXXXXXXXXX#XXXXXXXXXXXXXXXXXXXXXX#XX..X.
....#XXXXXXXXXXXXXXXXXXXXXXXXXXXXXXXXXXXXXXXXXXXXXXXXXXXXXXXXXXXXX#XXXXXXXXXXXXXXXXXXXXXXXXXXXXXXXXXXXXXXXXXXXXXXXXXXXXXXXXXXXXXXX
......XXXXXXXXX#X#XXXXXX#XXXXXXXXXXXXXXXXXXXXXXXXXXXXXXXXXXXXXXXXXXXXXXXXXXXXXXXXXXXXXXXXXXXXXXXX#XXXXXXXXXXXXXXXXXXXXXXXXX#XX..X.
XXXXXXXXXXXXXXXX#XXXXX#X.X#XXXXXXXXXXXXXXX#XXXXXXXXXXXXXXXXXXXXXXXXXXXXXXXXXXXXXXXXX#XXXX#XXXXXXXXXXXXXXXXXXXXXXXXXXX#XXXXX..#..X.
......XXXXXXXXX#XXXXXXXXXXXXXXXXXXXXXXXXXXXXXXXXXXXXXXXXXXXXXXXXXXXXXXXXXXXXXXXXXXXXXXXXX#XXXXXXXXXXXXXXXXXXXXXXXXXXXXXXXXXXXXXXXX
XXXXXXXXXXXXXXXXXXXXXXXXXX#XX##XXXXXXXXXXXXXXXXXXXXXXXXXXXXXXXXXXXXXXXXXXXXXXXXXXXXXXXXXXXXXXXXXXXXXXXXXXXXXXXXXXXXXXXXXXXXXXXXXXX
.##...XXXXXXXXXXXXXXXXX#.X#XXXXXXXXXXXXXXXXXXXXX#XXXXXXXXXXXXXXXXXXXXXXXXXXXXXXXXXXXXXXXXXXXXXX#XXXXXXXXXXXXXXXXXXXXXXXX#XX.....X.
XXXXXXXXXXXXXXXXXXXXXXXXXXXXXXXXXXXXXXXXXXXXXXXXXXXXXXXXXXXXXXXXXXXXXXXXXXXXXXXXXXXXXXXXXXXX#XXXXXXXXXXXX#XXXXXXXXXXXXXXXXXXXXXXXX
#.....XXXXXXXXXXXXXX#XXX#XXXXXXXXXXXXXXXXXXXXXX#XXXXXXXXXXXXXXX#XXXXXXXXXXXX#XXXXXXXXXXXXXXXXXXXXXXXXXXXXXXXXXXXX#XXXXXXXXX.....X.
......XXXXXXXXXXXXXXXXXXXXX#XXXXXXXX#XXXXXXXXXXXXXXXXXXXXXXXXXXXXXXXXXXXXXXXXXXXXXXXXXXXXXXXXXXXXXXXXXXXXXX#XXXXXXXXXXXXXXXXXXXXXX
......XXXXXXXXXXXXXXXXXXXXXXXXXX#XXX#XXX#X#XXXXXXX#XXXXXXXXXXXXXXXXX#XXXXXXX#XXXXXXXXXXXXXXX.##XXXXXXXXXXXXXXXXXXXXXXXXXXXXXXXXXXX
......XXXXXXXXXXXXXXXXXX#XXXXXXXXXXXXXXXXXXXXXXX#XXXXXXXXXXXXXXXXXXXXXXXXXXXXXXXXXXXXXXXXXXXXXXXXXXXXXXXXXXXXXXXXXXXXXXXXXXXXXXXXX
#...#.XXXXXXXXXXXXXX#XXXXXXXXXXXXXXXXXXXXXXXXXXXXXXXXXXXXXXXXXXXXXXXXXXXXXXXXXXXXXXXXXXXXXXXXX#XXXXXXXXXXXXXXXXXXXXXX.#XXXX.....X.
......XXX#XXXXXXXXXXXXXXXXXXX#XXXXXXXXXXXXXXXXXXXXXXXXXXXXXXXXXXXXXXXXXXXXXXX#XXXXXXXXXXXXXXXXXXX##XXXXXXXXXXXXXXXXXXXXXXXXXXXXXX#
.....#XXXXXXXXXXXXXXXXXXXXXXXXXXXXXXXXXXXXXXXXXXXXXXXXXXXXXXXXXXXXXXXXXXXXXXXXXXXXXXXXXXXXXXXXXXXXXXXXXXXXXXXXXXXXXXXXXXXXXXXXXXXX
.#....XXX#XXXXXXXXXXXXXXXXXXXXXXXXXXXXXXXXXXXXXXXXXXXXXXXXXXXXXXXXXXXXXXX#XXXXXXXXXXXXXXXXXXXXXXX#XXXXXXXXXXXXXXXX#XXXXXXXX..#..X.
XXXXXXXXXXXXXXXXXXXXXXXXXXXXXXXXXXXX#XXXXXXXXXX#.XXXXX#XXXXXXXXXXXXXXXXXXXXXXXXXXXXXXXXXXXXXXXXXXXXXXXXXXXXXXXXXXX#X#.#XX#X..#..X.
XXXXXXXXXXXXXXX.XXXXXX#XXXXXXXXXXXXXXXXXXXXXXXXXXXXXXXXXXXXXXXXXXXXXX##XXXXXXXXXXXXXXXXXX#XXXXXXXXXXXXXXXXXXXXXXXXXXXXXXXXXXXXXXXX
.X..#.XXX.X#XXXXXXXXXXXXXXXXXXX#XXXXXXXXXXXXXXXX#XXXXXXXXXXXXXXXXXXXXXXXXXXXXXXXXXXXXXXXXXXXXXXXXXXXXXXXXXXXXXXXXXXXXXXXXXXXXXX#X.
XXXXXXXXX.X#XXXXXXXXXXXXXXXXX##X#XXXXXXXXXXXXXXXXXXXXXXXXXXXXXXXXXXXXXXXXXXXXXXXXXXX#XX#XXXXXXXXXXXXXX.X#XXXXXXXXXXXXXXXXXX...X.X.
.X....#XX.X.#XX.XXX#.X.#.XXXXXXX#XXXXXXXXXXXXXXXXXXXXXXXXXXXXXXXXXXXXX#XXXX#XXXXXXXXXXX#XXXXXXXXXXXXXX.X#XXXXXXXXX.#XXXXXXX...X.X.
#X.....X##X..XX#XXXXXXXX#XXXXXXXXXXXXXXXXXXXXXXXXXXXXXXXXXXXXXXXXXXX#XXX#XXXXXXXXXX#XXXXXXXXXXXXX#XXXX.XXX#XXXXXXX#XXXXXXXXXXXXXXX
XXXXXXXXXXXXXXXXXXXXXX#X.XXXX#XXXXXXXXXXXXXXXXXXX#XXXXXXXXXXXXXXXXXXXXXXXXX#XXXXXXXXXXXXXXXXXXXXXXXX#XXXXXXXXXXXXXXXXXX#XXX#..X.X.
.X...#.X.XX..XX.X#XXX#XXXXXXXXXXXXXXXXXXXXXXXXX##XXXXXXX#XXXXXXXXXXXXXXXXXXXXXXXXXXXXXXXXXXXXX#XXXXXXXXXXXXXXXXXXXXXXXXXXXXXXXXXXX
XXXXXXXXXXXXXXXXXXXXXXXXXXXXXXXXXXXXXXXXXXXXXXXXXXXXXXXXXXXXXXXXXXXX#XXXXXXXXXXXXXXXXXXXXXXXXXXXXXXXXXXXXXXXXXXXXXXXXXXXXXXXXXXXXX
.X.....X#XXXXXXXXXXXXXXX#XXXXXXXXXXXXXXXXXXXXXXXXXXXXXXXXXXXXXXXXXXXXXXXXXXXXXXXXXXXXXXXXXXXXXXXXXXXXXXXXXXXXXXXXXXXXXXXXXXXXXXXXX
.X.....X..X..XX.XXXXXXX#XXXXXXXXXXXXXXXXXXXXXXXXX#XXXXXXXXXXXXXXXXXXXXXXXXXXXXXXXXXXXXXXXXXX#X#.X..#XX#XXXX#XXXXXXXXXXXXXXX...X.X.
.X.....X..X..XX.XXXXXXXX##XXXXXXXXXXXXXXXXXXXXXXXXXXXXXXXXXXXXXXXXXXXXXXXXXXXXXXXXXXXX#XXXXX#XXXXXXXXX#XXXX#XXXXXX#X.#XXXXX...X.X.
.X.....X..X..XX.XXXXXXXX#XXXXXXXX#XXXXXXXXXXXXXXXXXX#XXXXXXXXXXXXXXXX#.#X##XXXXXXXXXXXX#XXXXXXXXXXXXXXXXXXXXXXXXXXXXXXXXXXXXXXXXXX
XXXXXXXXXXXXXXXXXXXXXXXXXXXXXXXXXXXXXXXXXXXXXXXXXXXXXXX#XXXXXXXXXXXXXXXXXXXXXXXXX#XXXXXXXXXXXXX.X##XXXXXXXXXXXXXXXXXXX##XXX.#.X.#.
.X.....X#.X.#XXXXXXXXXXXXX#XXXXXXXXXXX#XXXXXXXX#XXXXXXXXXXXXXXXXXXXXXX#XXX#XXXXXXXXX#XX#XXXXXXXXXXXXXXXXXX#X#XXXXX.X.X.XX#X...X...
#X#....X..X..XX.XXXXXXX#XXXXXXXXXXXXXXXXXXXXXXXXXXXXXXXXXXXXXXXXXX#XXXXXXXXXXXXXXXXXXXXXXXXXXXXXXXXXXXXXXXXXXXXXXXXXXX#XXXX...X#..
XXXXXXXXXXXXXXXXXXXXXXXXXXXXXXXXXXXXXXXXXXXXXXX#XXXXXXXXXXXX#XXXXX#X#XXXXXXXXXXX#XXXXXXXX#X#XXXXXXXXXXXXXXXXXXXXXXXXXXXXXXXXXXXX#.
.X....#XXXXXXXXXXXXXXXXXXXXXXXXXXXXXXXXXXXXXXXXXX#XXXXXXXXXXXXXXXXXXXXXXXXXXXXXXXXXXXXXXXXXXXXXXXXXXXXXXXXXXXX#XXX.X.XX.X#X..#XX.#
.X....XXXXXXXXXXXXXX#XXXXXXXXXXXXXXXXXXXXXXXXXXXXXXXXXXXXXX#XXXX#XXXXXXXXXXXXXXXXXXXXXXXXXXXXXX#XXXXXXXXXXXXXXXXXXXX#XXXXXXXXXXXXX
.X....XX..X..XX.XXXXXX#X#XXXXX#XXXXXX#XXXX#XX#XXXXXXXXXXXXXXXXXXXXXXXXXXXXXXXXXXXXXXXXXXXXXXXXXXXXXXXXXXXXXXXXXXXXXXXXXXXXXXXXXXXX
.X...#XXXXXXXXXXXXXXXXXXXXXXXXXXXXXXXXXXXXXXXXXX#XXXXXXXXX#XXXXXXXXXXXXXXXXXXXXXXXXXXXXXXXXXXX#XXXXXXXXXXXXXXXX#XX.X.XX#XXX...XX..
.X.....X##XXXXXXXXXXXXXXXXXXXXXXXXXXXXXXXXXXXXXXXXXXXXXXXXXXXXXXXXXXXXXXXXXXXX#XXXXXXXXXXXXXXXXXXXXXXXXXXXXXXXXXXX#XXXXXXXXXXXXX#.
#XXXXXXXXXXXXXXXXXXXXXXXXXXXXXXXXXXXXXXXXX#XX#XXXX#XXXXXXXXXXXXXXXX#X#XXXXX#XXXXXXXXXXXXXXXXXXXX#XXXXXXXXXXXXXXXXXXXXXXXXXXXX#XX..
#....#.X#XX..XX.XXX#XXXXXXXXXXXXXXXXXX#XXXXXXXXXXXXXXXXXXXXXX#XXXXXXXXXXXXXXXXXXXXXXXXXXXXXXXXXXXXXXXXXXXXXXXXXXXXXXXXXXXXXXXXXXXX
.......X.XX..XX.XXX#XX#XXXX#XXXXXXXXXXXXXXXXXXX#XXXXXXXXXXXXXXXXXXXXXXXXXXX#X#XX#XXXXXXXXXXXX#XXXXXX#XXXXXXXXXXXXXXXX#XXXXX.X#X#..
.......X.XX..XX#XXXXXXXXXXXXXXXXXXXXXXXXXXXXXXXXXXXXXXXXXXXXXXXXXXXXXX#XXXXXX#XX#XXXXXXXXXXXX.X#XXXXXXXXXXXXXXXXXXXXX#XXXXX.X.X...
.......X.XX.#XX.X.XXXXXXXXXXXXXXXX#XXXXXXXXX#.X.X#XXXXXXXX.XX.XX.#XXXXXXX#XXX#XXXXXXXXXXXXXXX#XXXXXXXXXXXXXXXXXXXXXXX##X#XX.X.X...
....#..X.XX..XX.X#XXXXXXXXXXXXXXXXXX#XXXX#XXXXXXXXXXXXXXXXXXXXXXX#XXXXXXXXXXXXXXXXXXXXXXXXXXXXXXXXXXXXXXXXXXXXXX#XXX#XXXXXXXXXXXXX
XXXXXXXXXXXXXXXXXXXXXXXXXXXXXXXXXXXXXXXXXX#XXXX#XXXXXXXXXX#XX#XXX.XXXXXXXXXXXXXXXX#XXXXXX#XXXXXXXXXXXXXXXXXXXXXX#XXX#XXXXXX.X.X...
....X..X.XX.#XXXXXXXXXX#XXXXXXXXXXX#XXXXXX#XX#XXXXXXXXXXXXXXXXXXXXXXXXXXXXXXXXXXXXXXXXXXXXXXXXXXXXXXXXXXXXXXXXXXXXXX#XXXXXX.X.X...
...#XXXX.XX.XXXXXXXXX#XXXXXXXXXXXXXXXXXXXXXXXXXXXXXXXXXXXXXXXXXXXXXXXXXXXXXXXXXXXXX#XXXXXXXXXXXXXXXXXXXXXXXXXXXXXXXXXXXXXXXXXXXXXX
.....#.#.XX.XXX.X#XXXXXXXXXXXXXXXXXXXXXXXXXXXXXXXXXXXXXXXXXXXXXXXXXXXX#XXXXXXXXXXXXXXXXXX#XXXXXXXXXXXXXXX#XXXXXXXXXXXXXXXXX.X.X...
..#..XXXXXXXXXXXXXXXXXXXX##.XXXX#XX.XXXXXX#XXXXXXXXXXXXXX#XX#XXXXXXXXXXXX#XX#XXXXXXXXXXXXXXXXXXXXXXXXXXXXXXXXXXXXXXXXXXXX#X.X.X...
.....X...XX.XXX.X.X#X.X.X#XXXXXXXXX#XXXXXXXX#XXXXXXXXXXXXXXXXXXXX#XXXXXXXXXXXXXXXXXXXXXXXXXXXXXXXXXX#XXXXXXXXXXXXXXXX#XXXXXXXXXXXX
....#XXXXXX.XXX.X.X.X.X.X...XXXXXX#XXXXXXXXXXXXXXXXXXXXXXXXXXXXX#XXXXXXXXXXXXXXXXXXXXXXX#XXXXXXXXXXXXXXXXXXXXXXX#XXXXX#XXXX.X.X...
...#.....X#.XXX#X.X.X.X.X..#XXXXXXXXXXXXXXXXXXXXXXXXXXXX#XXXXX#XXXXXXXX#XXXXXX#XXXXXXXXXXXXXXXXXXXXXXXXXXXXXXXXXXXXXXXXXXXXXXXXXXX
........#XXXXXX.X.X#XXXXX...XX.X.X...X.XXX.XXXXX#XX#XX#XXXXXXXXXXXXXXXXXXXXXXXXXXXXXXXXXXXXXXX#XXXX#X##XXXXXXXXXXXXXXXXXXXXXXXXXXX
.......#....XX##X.X.X.X.#...XX.X.X...X.XXX#XXXXXXXXXXXXXXXXXXXXXXXXXXXXXXXXXXXXXXXXXXXXXXXXXXXXXXXXXXXXX#XXXX#XXXXXXXX#XXXX.X.X...
............XX..X.X.X#XXXXXXXXXXXXXXXXXXXX.X.XXXXXXXXXXXXXXXXXXXXX#X#XXXXXX#XXXXX##XXXX#XXXXXXXX#XXXXXXXXXXXXXXXXXXXXXXXXXXXXXXXXX
...........#XXXXXXXXX.X.....XX.X.##.#X.XX#.X#XXXXXXXXXXXXXXXXXXXXXXXXXXXXXXXXXXXXXXXXXXXXXXXXXXXXXXXXXXXXXXXXXXXXXXXXXXXXXXXXXXXXX
.............X..X.X.#.X....#XXXXXXXXXXXXXXXXXXXXXXXXXX.X..XX#XXXXXXXXXXXXXXXXXXXXXXXXXXXXXXXXXXXXXXXXXXXXXXXXXXXXX#XXX..X.#.X#X...
.............X..X.X...X.....XX.X.....X.XX..X.XXX.XX.X#.X..XX.X.#.X.X.XX.X.X..X.XX...XXX...XXXX.X.XX....#..XXX##X.#.XXX..X...X.X...
